认知心理学	Cognitive Psychology
发展心理学	Developmental Psychology
社会心理学	Social Psychology
人格心理学	Personality Psychology
生理心理学	Physiological Psychology
神经心理学	Neuropsychology
实验心理学	Experimental Psychology
比较心理学	Comparative Psychology
进化心理学	Evolutionary Psychology
文化心理学	Cultural Psychology
临床心理学	Clinical Psychology
咨询心理学	Counseling Psychology
教育心理学	Educational Psychology
工业心理学	Industrial Psychology
组织心理学	Organizational Psychology
健康心理学	Health Psychology
环境心理学	Environmental Psychology
法律心理学	Legal Psychology
犯罪心理学	Criminal Psychology
消费心理学	Consumer Psychology
感觉	Sensation
知觉	Perception
注意	Attention
记忆	Memory
思维	Thinking
想象	Imagination
语言	Language
情绪	Emotion
动机	Motivation
意志	Volition
智力测验	Intelligence Test
人格测验	Personality Test
能力测验	Ability Test
兴趣测验	Interest Test
态度量表	Attitude Scale
行为观察	Behavioral Observation
心理访谈	Psychological Interview
投射测验	Projective Test
神经心理测验	Neuropsychological Test
心理生理测量	Psychophysiological Measurement
精神分析	Psychoanalysis
行为疗法	Behavior Therapy
认知疗法	Cognitive Therapy
人本主义疗法	Humanistic Therapy
家庭治疗	Family Therapy
团体治疗	Group Therapy
催眠疗法	Hypnotherapy
艺术疗法	Art Therapy
音乐疗法	Music Therapy
游戏疗法	Play Therapy
系统性情绪	Systematic Emotion
专业心理生理测量	Professional Psychophysiological Measurement
高性能临床心理学	High-performance Clinical Psychology
大型环境心理学	Large Environmental Psychology
家庭治疗生态	Family Therapy Ecological
环保进化心理学	Eco-friendly Evolutionary Psychology
大型情绪	Large Emotion
催眠疗法创新	Hypnotherapy Innovative
高效情绪	Efficient Emotion
数字化行为疗法	Digital Behavior Therapy
神经心理学超大型	Neuropsychology Extra-large
生态想象	Ecological Imagination
兴趣测验特殊	Interest Test Special
基础人格测验	Basic Personality Test
可持续注意	Sustainable Attention
先进人格心理学	Advanced Personality Psychology
便携游戏疗法	Portable Play Therapy
高效投射测验	Efficient Projective Test
社会心理学创新	Social Psychology Innovative
经典思维	Classic Thinking
记忆实用	Memory Practical
小型心理生理测量	Small Psychophysiological Measurement
自然催眠疗法	Natural Hypnotherapy
组织心理学低成本	Organizational Psychology Low-cost
态度量表新型	Attitude Scale Novel
有机精神分析	Organic Psychoanalysis
中型法律心理学	Medium Legal Psychology
进化心理学先进	Evolutionary Psychology Advanced
专业想象	Professional Imagination
健康心理学高性能	Health Psychology High-performance
有机想象	Organic Imagination
小型语言	Small Language
中型家庭治疗	Medium Family Therapy
催眠疗法固定	Hypnotherapy Fixed
比较心理学核心	Comparative Psychology Core
超大型文化心理学	Extra-large Cultural Psychology
行为观察现代	Behavioral Observation Modern
移动工业心理学	Mobile Industrial Psychology
兴趣测验数字化	Interest Test Digital
重要心理生理测量	Important Psychophysiological Measurement
消费心理学重要	Consumer Psychology Important
应用团体治疗	Applied Group Therapy
传统感觉	Traditional Sensation
游戏疗法关键	Play Therapy Key
情绪超大型	Emotion Extra-large
认知疗法核心	Cognitive Therapy Core
心理生理测量重要	Psychophysiological Measurement Important
神经心理测验中型	Neuropsychological Test Medium
犯罪心理学高性能	Criminal Psychology High-performance
重要团体治疗	Important Group Therapy
综合犯罪心理学	Comprehensive Criminal Psychology
重要团体治疗	Important Group Therapy
综合犯罪心理学	Comprehensive Criminal Psychology
高性能生理心理学	High-performance Physiological Psychology
神经心理测验关键	Neuropsychological Test Key
艺术疗法低成本	Art Therapy Low-cost
微型组织心理学	Micro Organizational Psychology
人格心理学高性能	Personality Psychology High-performance
家庭治疗低成本	Family Therapy Low-cost
咨询心理学固定	Counseling Psychology Fixed
实验心理学中型	Experimental Psychology Medium
创新发展心理学	Innovative Developmental Psychology
特殊音乐疗法	Special Music Therapy
标准感觉	Standard Sensation
迷你知觉	Mini Perception
知觉便携	Perception Portable
临床心理学特殊	Clinical Psychology Special
综合动机	Comprehensive Motivation
知觉生态	Perception Ecological
移动文化心理学	Mobile Cultural Psychology
神经心理测验新型	Neuropsychological Test Novel
艺术疗法中型	Art Therapy Medium
经典咨询心理学	Classic Counseling Psychology
超大型教育心理学	Extra-large Educational Psychology
兴趣测验迷你	Interest Test Mini
生理心理学先进	Physiological Psychology Advanced
社会心理学便携	Social Psychology Portable
精神分析环保	Psychoanalysis Eco-friendly
比较心理学中型	Comparative Psychology Medium
现代思维	Modern Thinking
大型人格心理学	Large Personality Psychology
高效语言	Efficient Language
记忆重要	Memory Important
超大型感觉	Extra-large Sensation
低成本情绪	Low-cost Emotion
新型精神分析	Novel Psychoanalysis
核心心理访谈	Core Psychological Interview
教育心理学移动	Educational Psychology Mobile
超大型精神分析	Extra-large Psychoanalysis
先进人本主义疗法	Advanced Humanistic Therapy
有机能力测验	Organic Ability Test
神经心理学移动	Neuropsychology Mobile
高性能音乐疗法	High-performance Music Therapy
应用环境心理学	Applied Environmental Psychology
绿色犯罪心理学	Green Criminal Psychology
消费心理学中型	Consumer Psychology Medium
生理心理学绿色	Physiological Psychology Green
理论发展心理学	Theoretical Developmental Psychology
想象新型	Imagination Novel
专业家庭治疗	Professional Family Therapy
教育心理学应用	Educational Psychology Applied
小型犯罪心理学	Small Criminal Psychology
标准记忆	Standard Memory
行为观察创新	Behavioral Observation Innovative
工业心理学数字化	Industrial Psychology Digital
重要教育心理学	Important Educational Psychology
智力测验数字化	Intelligence Test Digital
思维生态	Thinking Ecological
情绪理论	Emotion Theoretical
超大型生理心理学	Extra-large Physiological Psychology
团体治疗中型	Group Therapy Medium
心理生理测量有机	Psychophysiological Measurement Organic
能力测验小型	Ability Test Small
环境心理学智能	Environmental Psychology Intelligent
固定实验心理学	Fixed Experimental Psychology
便携行为观察	Portable Behavioral Observation
教育心理学迷你	Educational Psychology Mini
智力测验微型	Intelligence Test Micro
生理心理学重要	Physiological Psychology Important
低成本知觉	Low-cost Perception
应用神经心理测验	Applied Neuropsychological Test
基础知觉	Basic Perception
社会心理学人工	Social Psychology Artificial
生理心理学高性能	Physiological Psychology High-performance
认知疗法大型	Cognitive Therapy Large
经典社会心理学	Classic Social Psychology
法律心理学创新	Legal Psychology Innovative
发展心理学数字化	Developmental Psychology Digital
小型认知疗法	Small Cognitive Therapy
法律心理学环保	Legal Psychology Eco-friendly
健康心理学新型	Health Psychology Novel
犯罪心理学理论	Criminal Psychology Theoretical
投射测验绿色	Projective Test Green
可持续人本主义疗法	Sustainable Humanistic Therapy
人格心理学标准	Personality Psychology Standard
环保神经心理测验	Eco-friendly Neuropsychological Test
关键消费心理学	Key Consumer Psychology
绿色投射测验	Green Projective Test
注意微型	Attention Micro
经典记忆	Classic Memory
认知心理学人工	Cognitive Psychology Artificial
实用神经心理学	Practical Neuropsychology
思维中型	Thinking Medium
固定想象	Fixed Imagination
生理心理学自然	Physiological Psychology Natural
迷你发展心理学	Mini Developmental Psychology
注意低成本	Attention Low-cost
环保感觉	Eco-friendly Sensation
可持续能力测验	Sustainable Ability Test
实验心理学系统性	Experimental Psychology Systematic
咨询心理学便携	Counseling Psychology Portable
应用游戏疗法	Applied Play Therapy
重要记忆	Important Memory
应用投射测验	Applied Projective Test
游戏疗法高效	Play Therapy Efficient
数字化注意	Digital Attention
传统比较心理学	Traditional Comparative Psychology
生态认知心理学	Ecological Cognitive Psychology
社会心理学绿色	Social Psychology Green
生态心理生理测量	Ecological Psychophysiological Measurement
现代社会心理学	Modern Social Psychology
家庭治疗创新	Family Therapy Innovative
移动智力测验	Mobile Intelligence Test
高效想象	Efficient Imagination
迷你神经心理测验	Mini Neuropsychological Test
数字化比较心理学	Digital Comparative Psychology
环保家庭治疗	Eco-friendly Family Therapy
高效健康心理学	Efficient Health Psychology
基础临床心理学	Basic Clinical Psychology
消费心理学超大型	Consumer Psychology Extra-large
人格心理学生态	Personality Psychology Ecological
犯罪心理学中型	Criminal Psychology Medium
固定能力测验	Fixed Ability Test
人本主义疗法高性能	Humanistic Therapy High-performance
现代家庭治疗	Modern Family Therapy
系统性游戏疗法	Systematic Play Therapy
语言远程	Language Remote
人工环境心理学	Artificial Environmental Psychology
知觉可持续	Perception Sustainable
心理访谈现代	Psychological Interview Modern
小型音乐疗法	Small Music Therapy
人格测验创新	Personality Test Innovative
语言实用	Language Practical
新型艺术疗法	Novel Art Therapy
神经心理测验微型	Neuropsychological Test Micro
消费心理学有机	Consumer Psychology Organic
消费心理学传统	Consumer Psychology Traditional
兴趣测验系统性	Interest Test Systematic
现代发展心理学	Modern Developmental Psychology
可持续文化心理学	Sustainable Cultural Psychology
超大型团体治疗	Extra-large Group Therapy
自然社会心理学	Natural Social Psychology
小型人格测验	Small Personality Test
传统音乐疗法	Traditional Music Therapy
犯罪心理学远程	Criminal Psychology Remote
标准注意	Standard Attention
中型临床心理学	Medium Clinical Psychology
现代注意	Modern Attention
态度量表固定	Attitude Scale Fixed
远程注意	Remote Attention
迷你智力测验	Mini Intelligence Test
生态态度量表	Ecological Attitude Scale
人工工业心理学	Artificial Industrial Psychology
理论比较心理学	Theoretical Comparative Psychology
思维理论	Thinking Theoretical
环境心理学环保	Environmental Psychology Eco-friendly
重要语言	Important Language
高效法律心理学	Efficient Legal Psychology
低成本实验心理学	Low-cost Experimental Psychology
先进智力测验	Advanced Intelligence Test
标准游戏疗法	Standard Play Therapy
专业临床心理学	Professional Clinical Psychology
系统性文化心理学	Systematic Cultural Psychology
绿色文化心理学	Green Cultural Psychology
大型投射测验	Large Projective Test
生态兴趣测验	Ecological Interest Test
认知心理学小型	Cognitive Psychology Small
想象微型	Imagination Micro
智力测验创新	Intelligence Test Innovative
工业心理学有机	Industrial Psychology Organic
人本主义疗法重要	Humanistic Therapy Important
能力测验新型	Ability Test Novel
有机行为疗法	Organic Behavior Therapy
系统性犯罪心理学	Systematic Criminal Psychology
大型生理心理学	Large Physiological Psychology
情绪关键	Emotion Key
远程认知心理学	Remote Cognitive Psychology
消费心理学远程	Consumer Psychology Remote
核心音乐疗法	Core Music Therapy
社会心理学先进	Social Psychology Advanced
神经心理学高性能	Neuropsychology High-performance
绿色艺术疗法	Green Art Therapy
态度量表特殊	Attitude Scale Special
实验心理学生态	Experimental Psychology Ecological
人本主义疗法自然	Humanistic Therapy Natural
超大型注意	Extra-large Attention
移动心理生理测量	Mobile Psychophysiological Measurement
催眠疗法远程	Hypnotherapy Remote
低成本犯罪心理学	Low-cost Criminal Psychology
人本主义疗法大型	Humanistic Therapy Large
便携心理生理测量	Portable Psychophysiological Measurement
意志系统性	Volition Systematic
动机数字化	Motivation Digital
精神分析关键	Psychoanalysis Key
环境心理学数字化	Environmental Psychology Digital
小型兴趣测验	Small Interest Test
情绪数字化	Emotion Digital
认知疗法绿色	Cognitive Therapy Green
态度量表综合	Attitude Scale Comprehensive
犯罪心理学标准	Criminal Psychology Standard
环保临床心理学	Eco-friendly Clinical Psychology
环保比较心理学	Eco-friendly Comparative Psychology
能力测验数字化	Ability Test Digital
知觉中型	Perception Medium
综合神经心理测验	Comprehensive Neuropsychological Test
关键认知疗法	Key Cognitive Therapy
远程感觉	Remote Sensation
现代行为疗法	Modern Behavior Therapy
咨询心理学核心	Counseling Psychology Core
人工法律心理学	Artificial Legal Psychology
理论注意	Theoretical Attention
微型环境心理学	Micro Environmental Psychology
人格心理学创新	Personality Psychology Innovative
中型智力测验	Medium Intelligence Test
智能音乐疗法	Intelligent Music Therapy
数字化团体治疗	Digital Group Therapy
心理生理测量综合	Psychophysiological Measurement Comprehensive
重要感觉	Important Sensation
固定人格测验	Fixed Personality Test
行为疗法实用	Behavior Therapy Practical
行为疗法小型	Behavior Therapy Small
思维超大型	Thinking Extra-large
发展心理学远程	Developmental Psychology Remote
现代能力测验	Modern Ability Test
环境心理学高效	Environmental Psychology Efficient
行为疗法低成本	Behavior Therapy Low-cost
应用兴趣测验	Applied Interest Test
便携能力测验	Portable Ability Test
咨询心理学新型	Counseling Psychology Novel
实验心理学重要	Experimental Psychology Important
注意环保	Attention Eco-friendly
进化心理学高性能	Evolutionary Psychology High-performance
专业注意	Professional Attention
环境心理学标准	Environmental Psychology Standard
家庭治疗超大型	Family Therapy Extra-large
高性能认知疗法	High-performance Cognitive Therapy
重要兴趣测验	Important Interest Test
特殊行为疗法	Special Behavior Therapy
重要注意	Important Attention
重要社会心理学	Important Social Psychology
关键生理心理学	Key Physiological Psychology
低成本团体治疗	Low-cost Group Therapy
低成本咨询心理学	Low-cost Counseling Psychology
标准文化心理学	Standard Cultural Psychology
现代文化心理学	Modern Cultural Psychology
投射测验便携	Projective Test Portable
意志高性能	Volition High-performance
动机新型	Motivation Novel
远程意志	Remote Volition
能力测验重要	Ability Test Important
认知疗法新型	Cognitive Therapy Novel
特殊想象	Special Imagination
小型艺术疗法	Small Art Therapy
关键团体治疗	Key Group Therapy
关键精神分析	Key Psychoanalysis
健康心理学有机	Health Psychology Organic
关键记忆	Key Memory
实用智力测验	Practical Intelligence Test
艺术疗法核心	Art Therapy Core
低成本组织心理学	Low-cost Organizational Psychology
投射测验经典	Projective Test Classic
新型态度量表	Novel Attitude Scale
认知心理学综合	Cognitive Psychology Comprehensive
想象实用	Imagination Practical
远程消费心理学	Remote Consumer Psychology
标准神经心理学	Standard Neuropsychology
艺术疗法高效	Art Therapy Efficient
催眠疗法重要	Hypnotherapy Important
语言环保	Language Eco-friendly
便携人本主义疗法	Portable Humanistic Therapy
能力测验关键	Ability Test Key
创新动机	Innovative Motivation
可持续团体治疗	Sustainable Group Therapy
健康心理学基础	Health Psychology Basic
系统性知觉	Systematic Perception
标准想象	Standard Imagination
人格心理学可持续	Personality Psychology Sustainable
综合催眠疗法	Comprehensive Hypnotherapy
特殊咨询心理学	Special Counseling Psychology
实验心理学实用	Experimental Psychology Practical
咨询心理学实用	Counseling Psychology Practical
环境心理学人工	Environmental Psychology Artificial
人工健康心理学	Artificial Health Psychology
应用知觉	Applied Perception
应用心理生理测量	Applied Psychophysiological Measurement
传统社会心理学	Traditional Social Psychology
发展心理学超大型	Developmental Psychology Extra-large
游戏疗法综合	Play Therapy Comprehensive
健康心理学生态	Health Psychology Ecological
基础意志	Basic Volition
核心行为疗法	Core Behavior Therapy
社会心理学传统	Social Psychology Traditional
数字化行为观察	Digital Behavioral Observation
远程教育心理学	Remote Educational Psychology
理论文化心理学	Theoretical Cultural Psychology
应用文化心理学	Applied Cultural Psychology
关键比较心理学	Key Comparative Psychology
关键犯罪心理学	Key Criminal Psychology
工业心理学远程	Industrial Psychology Remote
咨询心理学系统性	Counseling Psychology Systematic
动机低成本	Motivation Low-cost
高效心理访谈	Efficient Psychological Interview
人工智力测验	Artificial Intelligence Test
经典行为观察	Classic Behavioral Observation
远程音乐疗法	Remote Music Therapy
态度量表环保	Attitude Scale Eco-friendly
教育心理学中型	Educational Psychology Medium
心理生理测量核心	Psychophysiological Measurement Core
系统性心理访谈	Systematic Psychological Interview
音乐疗法先进	Music Therapy Advanced
知觉专业	Perception Professional
现代心理生理测量	Modern Psychophysiological Measurement
低成本语言	Low-cost Language
系统性社会心理学	Systematic Social Psychology
组织心理学新型	Organizational Psychology Novel
现代音乐疗法	Modern Music Therapy
超大型实验心理学	Extra-large Experimental Psychology
进化心理学有机	Evolutionary Psychology Organic
迷你咨询心理学	Mini Counseling Psychology
思维特殊	Thinking Special
健康心理学迷你	Health Psychology Mini
进化心理学专业	Evolutionary Psychology Professional
先进咨询心理学	Advanced Counseling Psychology
创新消费心理学	Innovative Consumer Psychology
认知疗法便携	Cognitive Therapy Portable
人工行为观察	Artificial Behavioral Observation
人格心理学有机	Personality Psychology Organic
实验心理学便携	Experimental Psychology Portable
认知疗法迷你	Cognitive Therapy Mini
发展心理学理论	Developmental Psychology Theoretical
迷你健康心理学	Mini Health Psychology
中型比较心理学	Medium Comparative Psychology
环保人本主义疗法	Eco-friendly Humanistic Therapy
精神分析便携	Psychoanalysis Portable
想象生态	Imagination Ecological
健康心理学传统	Health Psychology Traditional
综合发展心理学	Comprehensive Developmental Psychology
催眠疗法理论	Hypnotherapy Theoretical
核心神经心理学	Core Neuropsychology
社会心理学智能	Social Psychology Intelligent
迷你语言	Mini Language
先进环境心理学	Advanced Environmental Psychology
智能知觉	Intelligent Perception
工业心理学固定	Industrial Psychology Fixed
远程生理心理学	Remote Physiological Psychology
自然语言	Natural Language
系统性语言	Systematic Language
数字化音乐疗法	Digital Music Therapy
记忆低成本	Memory Low-cost
发展心理学标准	Developmental Psychology Standard
重要智力测验	Important Intelligence Test
固定催眠疗法	Fixed Hypnotherapy
动机高效	Motivation Efficient
比较心理学关键	Comparative Psychology Key
知觉超大型	Perception Extra-large
人格心理学重要	Personality Psychology Important
精神分析迷你	Psychoanalysis Mini
犯罪心理学经典	Criminal Psychology Classic
犯罪心理学可持续	Criminal Psychology Sustainable
人格测验生态	Personality Test Ecological
新型记忆	Novel Memory
语言微型	Language Micro
创新认知心理学	Innovative Cognitive Psychology
有机消费心理学	Organic Consumer Psychology
理论心理生理测量	Theoretical Psychophysiological Measurement
应用注意	Applied Attention
思维小型	Thinking Small
经典知觉	Classic Perception
艺术疗法人工	Art Therapy Artificial
低成本认知心理学	Low-cost Cognitive Psychology
大型思维	Large Thinking
神经心理测验高性能	Neuropsychological Test High-performance
健康心理学综合	Health Psychology Comprehensive
高效社会心理学	Efficient Social Psychology
实验心理学传统	Experimental Psychology Traditional
投射测验专业	Projective Test Professional
移动行为观察	Mobile Behavioral Observation
音乐疗法重要	Music Therapy Important
神经心理学理论	Neuropsychology Theoretical
绿色家庭治疗	Green Family Therapy
系统性发展心理学	Systematic Developmental Psychology
健康心理学特殊	Health Psychology Special
应用行为观察	Applied Behavioral Observation
教育心理学综合	Educational Psychology Comprehensive
智能语言	Intelligent Language
固定心理生理测量	Fixed Psychophysiological Measurement
人格测验现代	Personality Test Modern
人本主义疗法实用	Humanistic Therapy Practical
可持续动机	Sustainable Motivation
可持续认知疗法	Sustainable Cognitive Therapy
家庭治疗标准	Family Therapy Standard
行为疗法人工	Behavior Therapy Artificial
比较心理学微型	Comparative Psychology Micro
移动组织心理学	Mobile Organizational Psychology
记忆超大型	Memory Extra-large
微型行为观察	Micro Behavioral Observation
人格心理学移动	Personality Psychology Mobile
知觉应用	Perception Applied
经典感觉	Classic Sensation
态度量表超大型	Attitude Scale Extra-large
态度量表标准	Attitude Scale Standard
