教育学	Pedagogy
教育心理学	Educational Psychology
教育社会学	Educational Sociology
课程论	Curriculum Theory
教学论	Teaching Theory
德育论	Moral Education Theory
教育评价	Educational Evaluation
教育管理	Educational Management
比较教育学	Comparative Education
教育史	History of Education
讲授法	Lecture Method
讨论法	Discussion Method
实验法	Experimental Method
探究法	Inquiry Method
项目法	Project Method
合作学习	Cooperative Learning
问题解决	Problem Solving
案例教学	Case Teaching
情境教学	Situational Teaching
游戏教学	Game Teaching
教育技术学	Educational Technology
多媒体教学	Multimedia Teaching
远程教育	Distance Education
在线学习	Online Learning
混合式学习	Blended Learning
移动学习	Mobile Learning
虚拟现实	Virtual Reality
增强现实	Augmented Reality
人工智能教育	AI in Education
教育大数据	Educational Big Data
语文教育	Chinese Language Education
数学教育	Mathematics Education
英语教育	English Education
科学教育	Science Education
社会教育	Social Education
艺术教育	Arts Education
体育教育	Physical Education
音乐教育	Music Education
美术教育	Fine Arts Education
信息技术教育	Information Technology Education
学校管理	School Management
班级管理	Class Management
教师管理	Teacher Management
学生管理	Student Management
课程管理	Curriculum Management
教学管理	Teaching Management
质量管理	Quality Management
安全管理	Safety Management
后勤管理	Logistics Management
财务管理	Financial Management
教育心理学现代	Educational Psychology Modern
便携教育学	Portable Pedagogy
绿色质量管理	Green Quality Management
比较教育学大型	Comparative Education Large
教学论创新	Teaching Theory Innovative
现代艺术教育	Modern Arts Education
小型虚拟现实	Small Virtual Reality
情境教学移动	Situational Teaching Mobile
虚拟现实有机	Virtual Reality Organic
移动教学管理	Mobile Teaching Management
绿色教师管理	Green Teacher Management
教学管理便携	Teaching Management Portable
教学管理关键	Teaching Management Key
绿色教育评价	Green Educational Evaluation
关键人工智能教育	Key AI in Education
混合式学习便携	Blended Learning Portable
综合学校管理	Comprehensive School Management
理论教育史	Theoretical History of Education
特殊科学教育	Special Science Education
系统性音乐教育	Systematic Music Education
应用讨论法	Applied Discussion Method
迷你体育教育	Mini Physical Education
比较教育学先进	Comparative Education Advanced
人工远程教育	Artificial Distance Education
案例教学便携	Case Teaching Portable
安全管理中型	Safety Management Medium
社会教育有机	Social Education Organic
多媒体教学先进	Multimedia Teaching Advanced
课程管理环保	Curriculum Management Eco-friendly
重要后勤管理	Important Logistics Management
教育社会学有机	Educational Sociology Organic
教育管理生态	Educational Management Ecological
高性能问题解决	High-performance Problem Solving
人工教育管理	Artificial Educational Management
学生管理创新	Student Management Innovative
创新移动学习	Innovative Mobile Learning
超大型教学管理	Extra-large Teaching Management
人工智能教育理论	AI in Education Theoretical
教育大数据远程	Educational Big Data Remote
案例教学重要	Case Teaching Important
小型教育心理学	Small Educational Psychology
应用课程管理	Applied Curriculum Management
教学管理移动	Teaching Management Mobile
学校管理小型	School Management Small
大型后勤管理	Large Logistics Management
游戏教学人工	Game Teaching Artificial
教育社会学先进	Educational Sociology Advanced
迷你多媒体教学	Mini Multimedia Teaching
生态讨论法	Ecological Discussion Method
教育管理固定	Educational Management Fixed
多媒体教学核心	Multimedia Teaching Core
重要多媒体教学	Important Multimedia Teaching
探究法有机	Inquiry Method Organic
关键教育管理	Key Educational Management
综合案例教学	Comprehensive Case Teaching
智能实验法	Intelligent Experimental Method
高性能教育大数据	High-performance Educational Big Data
有机移动学习	Organic Mobile Learning
超大型学校管理	Extra-large School Management
人工智能教育固定	AI in Education Fixed
讲授法环保	Lecture Method Eco-friendly
系统性课程管理	Systematic Curriculum Management
新型教育技术学	Novel Educational Technology
实验法现代	Experimental Method Modern
有机探究法	Organic Inquiry Method
核心学校管理	Core School Management
德育论移动	Moral Education Theory Mobile
环保案例教学	Eco-friendly Case Teaching
讨论法基础	Discussion Method Basic
移动课程管理	Mobile Curriculum Management
远程教育高效	Distance Education Efficient
重要教育管理	Important Educational Management
体育教育专业	Physical Education Professional
远程教育远程	Distance Education Remote
讨论法传统	Discussion Method Traditional
便携教育大数据	Portable Educational Big Data
远程教育自然	Distance Education Natural
合作学习关键	Cooperative Learning Key
理论移动学习	Theoretical Mobile Learning
环保质量管理	Eco-friendly Quality Management
信息技术教育现代	Information Technology Education Modern
基础教育管理	Basic Educational Management
关键科学教育	Key Science Education
小型科学教育	Small Science Education
合作学习可持续	Cooperative Learning Sustainable
远程混合式学习	Remote Blended Learning
中型安全管理	Medium Safety Management
新型教学论	Novel Teaching Theory
教育史标准	History of Education Standard
现代社会教育	Modern Social Education
传统教育学	Traditional Pedagogy
移动学习便携	Mobile Learning Portable
经典教育管理	Classic Educational Management
迷你教师管理	Mini Teacher Management
社会教育远程	Social Education Remote
信息技术教育生态	Information Technology Education Ecological
语文教育有机	Chinese Language Education Organic
生态讲授法	Ecological Lecture Method
传统项目法	Traditional Project Method
教育史移动	History of Education Mobile
核心讲授法	Core Lecture Method
学校管理低成本	School Management Low-cost
在线学习远程	Online Learning Remote
新型艺术教育	Novel Arts Education
创新数学教育	Innovative Mathematics Education
移动学习核心	Mobile Learning Core
音乐教育超大型	Music Education Extra-large
系统性质量管理	Systematic Quality Management
游戏教学中型	Game Teaching Medium
财务管理低成本	Financial Management Low-cost
社会教育综合	Social Education Comprehensive
在线学习中型	Online Learning Medium
教育管理小型	Educational Management Small
大型安全管理	Large Safety Management
实验法迷你	Experimental Method Mini
财务管理环保	Financial Management Eco-friendly
移动学习自然	Mobile Learning Natural
核心混合式学习	Core Blended Learning
便携教育心理学	Portable Educational Psychology
问题解决先进	Problem Solving Advanced
人工智能教育重要	AI in Education Important
理论比较教育学	Theoretical Comparative Education
教育评价综合	Educational Evaluation Comprehensive
生态移动学习	Ecological Mobile Learning
增强现实实用	Augmented Reality Practical
英语教育高效	English Education Efficient
便携教育社会学	Portable Educational Sociology
问题解决标准	Problem Solving Standard
安全管理微型	Safety Management Micro
核心教育管理	Core Educational Management
理论音乐教育	Theoretical Music Education
标准财务管理	Standard Financial Management
微型质量管理	Micro Quality Management
特殊班级管理	Special Class Management
新型教育社会学	Novel Educational Sociology
社会教育数字化	Social Education Digital
案例教学理论	Case Teaching Theoretical
项目法基础	Project Method Basic
创新项目法	Innovative Project Method
可持续体育教育	Sustainable Physical Education
教学管理创新	Teaching Management Innovative
固定语文教育	Fixed Chinese Language Education
新型教育心理学	Novel Educational Psychology
自然教育技术学	Natural Educational Technology
语文教育关键	Chinese Language Education Key
数字化质量管理	Digital Quality Management
多媒体教学迷你	Multimedia Teaching Mini
教育技术学移动	Educational Technology Mobile
迷你英语教育	Mini English Education
理论实验法	Theoretical Experimental Method
混合式学习数字化	Blended Learning Digital
质量管理大型	Quality Management Large
微型教育技术学	Micro Educational Technology
多媒体教学高效	Multimedia Teaching Efficient
环保移动学习	Eco-friendly Mobile Learning
音乐教育数字化	Music Education Digital
有机问题解决	Organic Problem Solving
系统性多媒体教学	Systematic Multimedia Teaching
教学论综合	Teaching Theory Comprehensive
学生管理应用	Student Management Applied
中型教师管理	Medium Teacher Management
教学论系统性	Teaching Theory Systematic
课程论可持续	Curriculum Theory Sustainable
课程管理创新	Curriculum Management Innovative
关键教育心理学	Key Educational Psychology
自然项目法	Natural Project Method
专业课程论	Professional Curriculum Theory
绿色游戏教学	Green Game Teaching
创新安全管理	Innovative Safety Management
教育评价固定	Educational Evaluation Fixed
超大型教育评价	Extra-large Educational Evaluation
核心游戏教学	Core Game Teaching
高性能讨论法	High-performance Discussion Method
重要虚拟现实	Important Virtual Reality
高效教学管理	Efficient Teaching Management
先进科学教育	Advanced Science Education
可持续后勤管理	Sustainable Logistics Management
混合式学习高效	Blended Learning Efficient
语文教育综合	Chinese Language Education Comprehensive
远程体育教育	Remote Physical Education
增强现实大型	Augmented Reality Large
高性能比较教育学	High-performance Comparative Education
体育教育移动	Physical Education Mobile
比较教育学现代	Comparative Education Modern
超大型信息技术教育	Extra-large Information Technology Education
有机班级管理	Organic Class Management
标准虚拟现实	Standard Virtual Reality
在线学习系统性	Online Learning Systematic
迷你在线学习	Mini Online Learning
学校管理实用	School Management Practical
固定比较教育学	Fixed Comparative Education
讲授法专业	Lecture Method Professional
现代音乐教育	Modern Music Education
中型数学教育	Medium Mathematics Education
小型项目法	Small Project Method
讲授法固定	Lecture Method Fixed
人工课程管理	Artificial Curriculum Management
讨论法自然	Discussion Method Natural
系统性体育教育	Systematic Physical Education
教育管理高效	Educational Management Efficient
比较教育学小型	Comparative Education Small
移动学习中型	Mobile Learning Medium
合作学习数字化	Cooperative Learning Digital
艺术教育系统性	Arts Education Systematic
远程教育大型	Distance Education Large
学校管理先进	School Management Advanced
经典英语教育	Classic English Education
实验法传统	Experimental Method Traditional
特殊质量管理	Special Quality Management
经典数学教育	Classic Mathematics Education
教师管理高效	Teacher Management Efficient
超大型教育史	Extra-large History of Education
社会教育移动	Social Education Mobile
综合移动学习	Comprehensive Mobile Learning
可持续课程论	Sustainable Curriculum Theory
小型混合式学习	Small Blended Learning
特殊教育评价	Special Educational Evaluation
绿色数学教育	Green Mathematics Education
自然多媒体教学	Natural Multimedia Teaching
质量管理关键	Quality Management Key
可持续问题解决	Sustainable Problem Solving
新型英语教育	Novel English Education
移动混合式学习	Mobile Blended Learning
体育教育智能	Physical Education Intelligent
教育社会学生态	Educational Sociology Ecological
教育学智能	Pedagogy Intelligent
实验法小型	Experimental Method Small
环保探究法	Eco-friendly Inquiry Method
教育史基础	History of Education Basic
教师管理有机	Teacher Management Organic
环保课程管理	Eco-friendly Curriculum Management
案例教学大型	Case Teaching Large
探究法智能	Inquiry Method Intelligent
特殊合作学习	Special Cooperative Learning
语文教育先进	Chinese Language Education Advanced
德育论新型	Moral Education Theory Novel
问题解决系统性	Problem Solving Systematic
标准探究法	Standard Inquiry Method
在线学习大型	Online Learning Large
可持续教育大数据	Sustainable Educational Big Data
移动学校管理	Mobile School Management
专业合作学习	Professional Cooperative Learning
先进财务管理	Advanced Financial Management
实用艺术教育	Practical Arts Education
绿色问题解决	Green Problem Solving
教学管理高效	Teaching Management Efficient
有机英语教育	Organic English Education
案例教学生态	Case Teaching Ecological
创新课程管理	Innovative Curriculum Management
教育心理学智能	Educational Psychology Intelligent
超大型语文教育	Extra-large Chinese Language Education
人工智能教育综合	AI in Education Comprehensive
增强现实环保	Augmented Reality Eco-friendly
经典教育评价	Classic Educational Evaluation
人工数学教育	Artificial Mathematics Education
固定音乐教育	Fixed Music Education
自然班级管理	Natural Class Management
实用体育教育	Practical Physical Education
低成本科学教育	Low-cost Science Education
教师管理人工	Teacher Management Artificial
微型混合式学习	Micro Blended Learning
数学教育自然	Mathematics Education Natural
小型教学管理	Small Teaching Management
社会教育迷你	Social Education Mini
专业教学论	Professional Teaching Theory
大型课程论	Large Curriculum Theory
生态美术教育	Ecological Fine Arts Education
教师管理中型	Teacher Management Medium
绿色讲授法	Green Lecture Method
英语教育高性能	English Education High-performance
班级管理便携	Class Management Portable
项目法环保	Project Method Eco-friendly
质量管理现代	Quality Management Modern
问题解决移动	Problem Solving Mobile
信息技术教育传统	Information Technology Education Traditional
便携班级管理	Portable Class Management
教育技术学迷你	Educational Technology Mini
迷你混合式学习	Mini Blended Learning
人工智能教育有机	AI in Education Organic
中型美术教育	Medium Fine Arts Education
超大型后勤管理	Extra-large Logistics Management
体育教育高性能	Physical Education High-performance
大型人工智能教育	Large AI in Education
生态教育大数据	Ecological Educational Big Data
艺术教育远程	Arts Education Remote
教育史实用	History of Education Practical
固定问题解决	Fixed Problem Solving
合作学习系统性	Cooperative Learning Systematic
基础情境教学	Basic Situational Teaching
先进学生管理	Advanced Student Management
数学教育重要	Mathematics Education Important
标准学生管理	Standard Student Management
在线学习固定	Online Learning Fixed
虚拟现实标准	Virtual Reality Standard
基础移动学习	Basic Mobile Learning
有机教育技术学	Organic Educational Technology
教育史环保	History of Education Eco-friendly
可持续教学管理	Sustainable Teaching Management
教育史中型	History of Education Medium
自然合作学习	Natural Cooperative Learning
系统性教育技术学	Systematic Educational Technology
经典教学论	Classic Teaching Theory
关键讨论法	Key Discussion Method
人工智能教育核心	AI in Education Core
远程教育有机	Distance Education Organic
关键虚拟现实	Key Virtual Reality
学校管理标准	School Management Standard
特殊社会教育	Special Social Education
教育评价标准	Educational Evaluation Standard
绿色信息技术教育	Green Information Technology Education
专业问题解决	Professional Problem Solving
绿色财务管理	Green Financial Management
实验法高效	Experimental Method Efficient
数学教育实用	Mathematics Education Practical
艺术教育现代	Arts Education Modern
特殊人工智能教育	Special AI in Education
固定教育社会学	Fixed Educational Sociology
高效课程论	Efficient Curriculum Theory
可持续虚拟现实	Sustainable Virtual Reality
移动德育论	Mobile Moral Education Theory
特殊教育社会学	Special Educational Sociology
讨论法关键	Discussion Method Key
班级管理超大型	Class Management Extra-large
特殊教学管理	Special Teaching Management
社会教育超大型	Social Education Extra-large
教学论远程	Teaching Theory Remote
教育学数字化	Pedagogy Digital
后勤管理重要	Logistics Management Important
社会教育智能	Social Education Intelligent
德育论系统性	Moral Education Theory Systematic
课程管理系统性	Curriculum Management Systematic
环保人工智能教育	Eco-friendly AI in Education
案例教学基础	Case Teaching Basic
教育心理学迷你	Educational Psychology Mini
教育史远程	History of Education Remote
教学管理可持续	Teaching Management Sustainable
大型讨论法	Large Discussion Method
游戏教学创新	Game Teaching Innovative
教育评价重要	Educational Evaluation Important
教育社会学高性能	Educational Sociology High-performance
数学教育新型	Mathematics Education Novel
先进体育教育	Advanced Physical Education
学生管理高效	Student Management Efficient
探究法标准	Inquiry Method Standard
远程在线学习	Remote Online Learning
中型增强现实	Medium Augmented Reality
课程论关键	Curriculum Theory Key
虚拟现实特殊	Virtual Reality Special
创新人工智能教育	Innovative AI in Education
教育史数字化	History of Education Digital
安全管理生态	Safety Management Ecological
基础教育技术学	Basic Educational Technology
综合混合式学习	Comprehensive Blended Learning
实验法固定	Experimental Method Fixed
班级管理关键	Class Management Key
关键美术教育	Key Fine Arts Education
安全管理人工	Safety Management Artificial
合作学习标准	Cooperative Learning Standard
移动学习现代	Mobile Learning Modern
有机学生管理	Organic Student Management
现代比较教育学	Modern Comparative Education
教师管理可持续	Teacher Management Sustainable
情境教学理论	Situational Teaching Theoretical
经典德育论	Classic Moral Education Theory
德育论固定	Moral Education Theory Fixed
后勤管理专业	Logistics Management Professional
教育社会学综合	Educational Sociology Comprehensive
标准信息技术教育	Standard Information Technology Education
讲授法远程	Lecture Method Remote
班级管理先进	Class Management Advanced
传统教学管理	Traditional Teaching Management
英语教育标准	English Education Standard
重要人工智能教育	Important AI in Education
科学教育标准	Science Education Standard
教学论绿色	Teaching Theory Green
教学论核心	Teaching Theory Core
实验法先进	Experimental Method Advanced
教育学人工	Pedagogy Artificial
远程教育数字化	Distance Education Digital
科学教育高效	Science Education Efficient
增强现实特殊	Augmented Reality Special
音乐教育高效	Music Education Efficient
综合英语教育	Comprehensive English Education
安全管理专业	Safety Management Professional
讨论法生态	Discussion Method Ecological
系统性移动学习	Systematic Mobile Learning
有机案例教学	Organic Case Teaching
传统信息技术教育	Traditional Information Technology Education
特殊教育管理	Special Educational Management
核心教育评价	Core Educational Evaluation
低成本学生管理	Low-cost Student Management
标准讨论法	Standard Discussion Method
生态合作学习	Ecological Cooperative Learning
小型安全管理	Small Safety Management
绿色社会教育	Green Social Education
数字化学校管理	Digital School Management
教育史便携	History of Education Portable
实验法超大型	Experimental Method Extra-large
后勤管理生态	Logistics Management Ecological
小型财务管理	Small Financial Management
多媒体教学便携	Multimedia Teaching Portable
固定艺术教育	Fixed Arts Education
环保教育社会学	Eco-friendly Educational Sociology
学生管理小型	Student Management Small
远程科学教育	Remote Science Education
自然后勤管理	Natural Logistics Management
人工智能教育新型	AI in Education Novel
生态在线学习	Ecological Online Learning
后勤管理迷你	Logistics Management Mini
绿色教育心理学	Green Educational Psychology
理论学校管理	Theoretical School Management
教学管理理论	Teaching Management Theoretical
可持续探究法	Sustainable Inquiry Method
经典课程管理	Classic Curriculum Management
教育史新型	History of Education Novel
环保多媒体教学	Eco-friendly Multimedia Teaching
音乐教育移动	Music Education Mobile
移动教师管理	Mobile Teacher Management
便携混合式学习	Portable Blended Learning
信息技术教育远程	Information Technology Education Remote
微型问题解决	Micro Problem Solving
教育大数据系统性	Educational Big Data Systematic
比较教育学移动	Comparative Education Mobile
数学教育微型	Mathematics Education Micro
超大型社会教育	Extra-large Social Education
经典教育社会学	Classic Educational Sociology
应用多媒体教学	Applied Multimedia Teaching
学生管理专业	Student Management Professional
德育论智能	Moral Education Theory Intelligent
标准学校管理	Standard School Management
移动学习专业	Mobile Learning Professional
教师管理移动	Teacher Management Mobile
学校管理可持续	School Management Sustainable
生态艺术教育	Ecological Arts Education
教学管理传统	Teaching Management Traditional
社会教育实用	Social Education Practical
案例教学移动	Case Teaching Mobile
问题解决关键	Problem Solving Key
环保学校管理	Eco-friendly School Management
核心合作学习	Core Cooperative Learning
移动学习理论	Mobile Learning Theoretical
人工比较教育学	Artificial Comparative Education
财务管理特殊	Financial Management Special
远程教育小型	Distance Education Small
环保教育学	Eco-friendly Pedagogy
混合式学习移动	Blended Learning Mobile
特殊案例教学	Special Case Teaching
安全管理高性能	Safety Management High-performance
小型学生管理	Small Student Management
关键远程教育	Key Distance Education
