大气	Atmosphere
水体	Water Body
土壤	Soil
生物	Organism
噪声	Noise
辐射	Radiation
固体废物	Solid Waste
有害物质	Harmful Substance
生态系统	Ecosystem
生物多样性	Biodiversity
大气污染	Air Pollution
水污染	Water Pollution
土壤污染	Soil Pollution
噪声污染	Noise Pollution
光污染	Light Pollution
热污染	Thermal Pollution
放射性污染	Radioactive Pollution
白色污染	White Pollution
重金属污染	Heavy Metal Pollution
有机污染	Organic Pollution
环境监测	Environmental Monitoring
环境评价	Environmental Assessment
环境规划	Environmental Planning
环境管理	Environmental Management
清洁生产	Cleaner Production
循环经济	Circular Economy
绿色发展	Green Development
可持续发展	Sustainable Development
生态文明	Ecological Civilization
环保产业	Environmental Protection Industry
污水处理	Wastewater Treatment
废气处理	Exhaust Gas Treatment
固废处理	Solid Waste Treatment
噪声控制	Noise Control
生态修复	Ecological Restoration
土壤修复	Soil Remediation
湿地保护	Wetland Protection
森林保护	Forest Protection
荒漠化防治	Desertification Control
生物多样性保护	Biodiversity Conservation
气候变化	Climate Change
全球变暖	Global Warming
臭氧层破坏	Ozone Depletion
酸雨	Acid Rain
海平面上升	Sea Level Rise
生物多样性减少	Biodiversity Loss
森林锐减	Forest Decline
荒漠化	Desertification
水资源短缺	Water Scarcity
极端天气	Extreme Weather
现代森林锐减	Modern Forest Decline
可持续生态修复	Sustainable Ecological Restoration
经典海平面上升	Classic Sea Level Rise
环境管理现代	Environmental Management Modern
综合大气污染	Comprehensive Air Pollution
自然噪声污染	Natural Noise Pollution
水体微型	Water Body Micro
综合生物	Comprehensive Organism
臭氧层破坏超大型	Ozone Depletion Extra-large
低成本水污染	Low-cost Water Pollution
智能噪声	Intelligent Noise
土壤修复远程	Soil Remediation Remote
生物多样性数字化	Biodiversity Digital
土壤智能	Soil Intelligent
重要噪声污染	Important Noise Pollution
热污染生态	Thermal Pollution Ecological
远程气候变化	Remote Climate Change
生物便携	Organism Portable
森林锐减实用	Forest Decline Practical
噪声应用	Noise Applied
超大型环境管理	Extra-large Environmental Management
先进有害物质	Advanced Harmful Substance
微型大气污染	Micro Air Pollution
高性能环境规划	High-performance Environmental Planning
生态环保产业	Ecological Environmental Protection Industry
系统性噪声控制	Systematic Noise Control
中型生物多样性减少	Medium Biodiversity Loss
荒漠化低成本	Desertification Low-cost
有害物质环保	Harmful Substance Eco-friendly
核心极端天气	Core Extreme Weather
远程生物多样性减少	Remote Biodiversity Loss
绿色水污染	Green Water Pollution
绿色发展智能	Green Development Intelligent
荒漠化防治环保	Desertification Control Eco-friendly
标准大气污染	Standard Air Pollution
放射性污染环保	Radioactive Pollution Eco-friendly
土壤修复现代	Soil Remediation Modern
便携土壤	Portable Soil
高性能大气污染	High-performance Air Pollution
微型生态文明	Micro Ecological Civilization
核心有害物质	Core Harmful Substance
核心生物多样性保护	Core Biodiversity Conservation
污水处理专业	Wastewater Treatment Professional
噪声传统	Noise Traditional
传统荒漠化	Traditional Desertification
数字化辐射	Digital Radiation
理论森林保护	Theoretical Forest Protection
森林锐减专业	Forest Decline Professional
放射性污染经典	Radioactive Pollution Classic
森林锐减低成本	Forest Decline Low-cost
迷你水资源短缺	Mini Water Scarcity
有害物质特殊	Harmful Substance Special
环境评价核心	Environmental Assessment Core
循环经济基础	Circular Economy Basic
迷你生物	Mini Organism
固体废物重要	Solid Waste Important
噪声迷你	Noise Mini
远程大气污染	Remote Air Pollution
实用生物	Practical Organism
大型大气污染	Large Air Pollution
高性能生态修复	High-performance Ecological Restoration
大气有机	Atmosphere Organic
可持续荒漠化防治	Sustainable Desertification Control
可持续荒漠化	Sustainable Desertification
绿色固废处理	Green Solid Waste Treatment
生物多样性保护远程	Biodiversity Conservation Remote
高性能湿地保护	High-performance Wetland Protection
有机污染特殊	Organic Pollution Special
生态文明智能	Ecological Civilization Intelligent
光污染先进	Light Pollution Advanced
生物大型	Organism Large
土壤标准	Soil Standard
特殊可持续发展	Special Sustainable Development
标准有害物质	Standard Harmful Substance
环境评价传统	Environmental Assessment Traditional
环境管理专业	Environmental Management Professional
可持续辐射	Sustainable Radiation
迷你森林锐减	Mini Forest Decline
环境规划基础	Environmental Planning Basic
环保水体	Eco-friendly Water Body
有机白色污染	Organic White Pollution
迷你噪声污染	Mini Noise Pollution
放射性污染小型	Radioactive Pollution Small
重金属污染重要	Heavy Metal Pollution Important
生态文明基础	Ecological Civilization Basic
极端天气可持续	Extreme Weather Sustainable
高效循环经济	Efficient Circular Economy
智能生物	Intelligent Organism
辐射中型	Radiation Medium
土壤修复可持续	Soil Remediation Sustainable
创新噪声控制	Innovative Noise Control
智能湿地保护	Intelligent Wetland Protection
数字化可持续发展	Digital Sustainable Development
清洁生产生态	Cleaner Production Ecological
创新固废处理	Innovative Solid Waste Treatment
标准噪声控制	Standard Noise Control
高效固体废物	Efficient Solid Waste
小型环境评价	Small Environmental Assessment
超大型土壤修复	Extra-large Soil Remediation
微型放射性污染	Micro Radioactive Pollution
自然白色污染	Natural White Pollution
生态生态系统	Ecological Ecosystem
综合环境评价	Comprehensive Environmental Assessment
便携可持续发展	Portable Sustainable Development
环保清洁生产	Eco-friendly Cleaner Production
低成本环境监测	Low-cost Environmental Monitoring
海平面上升超大型	Sea Level Rise Extra-large
经典土壤污染	Classic Soil Pollution
生物特殊	Organism Special
环境监测中型	Environmental Monitoring Medium
土壤污染小型	Soil Pollution Small
水资源短缺理论	Water Scarcity Theoretical
清洁生产移动	Cleaner Production Mobile
气候变化智能	Climate Change Intelligent
重要放射性污染	Important Radioactive Pollution
气候变化远程	Climate Change Remote
经典噪声污染	Classic Noise Pollution
人工土壤污染	Artificial Soil Pollution
大型水体	Large Water Body
湿地保护人工	Wetland Protection Artificial
基础绿色发展	Basic Green Development
土壤污染专业	Soil Pollution Professional
远程固体废物	Remote Solid Waste
新型噪声控制	Novel Noise Control
生物多样性减少数字化	Biodiversity Loss Digital
噪声污染综合	Noise Pollution Comprehensive
生物多样性减少基础	Biodiversity Loss Basic
酸雨创新	Acid Rain Innovative
噪声基础	Noise Basic
放射性污染现代	Radioactive Pollution Modern
可持续生物多样性	Sustainable Biodiversity
智能环境监测	Intelligent Environmental Monitoring
超大型臭氧层破坏	Extra-large Ozone Depletion
自然酸雨	Natural Acid Rain
小型酸雨	Small Acid Rain
森林锐减生态	Forest Decline Ecological
专业大气污染	Professional Air Pollution
土壤小型	Soil Small
可持续固体废物	Sustainable Solid Waste
系统性森林锐减	Systematic Forest Decline
生态系统中型	Ecosystem Medium
经典水资源短缺	Classic Water Scarcity
移动有害物质	Mobile Harmful Substance
低成本循环经济	Low-cost Circular Economy
生物多样性创新	Biodiversity Innovative
高效噪声污染	Efficient Noise Pollution
智能荒漠化防治	Intelligent Desertification Control
全球变暖迷你	Global Warming Mini
有机清洁生产	Organic Cleaner Production
特殊光污染	Special Light Pollution
放射性污染高性能	Radioactive Pollution High-performance
环境管理固定	Environmental Management Fixed
系统性森林保护	Systematic Forest Protection
生态修复自然	Ecological Restoration Natural
清洁生产经典	Cleaner Production Classic
重金属污染人工	Heavy Metal Pollution Artificial
污水处理生态	Wastewater Treatment Ecological
便携噪声控制	Portable Noise Control
臭氧层破坏高效	Ozone Depletion Efficient
系统性土壤修复	Systematic Soil Remediation
移动环境监测	Mobile Environmental Monitoring
水资源短缺系统性	Water Scarcity Systematic
生物人工	Organism Artificial
数字化有害物质	Digital Harmful Substance
生物多样性减少理论	Biodiversity Loss Theoretical
新型气候变化	Novel Climate Change
移动噪声控制	Mobile Noise Control
高效环保产业	Efficient Environmental Protection Industry
废气处理新型	Exhaust Gas Treatment Novel
迷你循环经济	Mini Circular Economy
环境监测专业	Environmental Monitoring Professional
辐射现代	Radiation Modern
海平面上升迷你	Sea Level Rise Mini
移动绿色发展	Mobile Green Development
固废处理有机	Solid Waste Treatment Organic
生物多样性高性能	Biodiversity High-performance
生态文明远程	Ecological Civilization Remote
生态绿色发展	Ecological Green Development
基础噪声	Basic Noise
高效环境监测	Efficient Environmental Monitoring
实用环保产业	Practical Environmental Protection Industry
低成本放射性污染	Low-cost Radioactive Pollution
生物多样性关键	Biodiversity Key
噪声生态	Noise Ecological
气候变化绿色	Climate Change Green
酸雨可持续	Acid Rain Sustainable
重要清洁生产	Important Cleaner Production
可持续噪声	Sustainable Noise
移动生物多样性	Mobile Biodiversity
人工污水处理	Artificial Wastewater Treatment
土壤高性能	Soil High-performance
经典光污染	Classic Light Pollution
特殊森林锐减	Special Forest Decline
辐射经典	Radiation Classic
辐射超大型	Radiation Extra-large
生态土壤修复	Ecological Soil Remediation
光污染高性能	Light Pollution High-performance
应用土壤污染	Applied Soil Pollution
湿地保护智能	Wetland Protection Intelligent
气候变化实用	Climate Change Practical
重金属污染智能	Heavy Metal Pollution Intelligent
标准放射性污染	Standard Radioactive Pollution
噪声污染大型	Noise Pollution Large
绿色热污染	Green Thermal Pollution
先进环境规划	Advanced Environmental Planning
土壤迷你	Soil Mini
污水处理移动	Wastewater Treatment Mobile
理论固体废物	Theoretical Solid Waste
基础生态修复	Basic Ecological Restoration
循环经济智能	Circular Economy Intelligent
应用生物	Applied Organism
高性能重金属污染	High-performance Heavy Metal Pollution
关键大气	Key Atmosphere
中型有机污染	Medium Organic Pollution
高性能循环经济	High-performance Circular Economy
环境监测实用	Environmental Monitoring Practical
大气污染应用	Air Pollution Applied
低成本水体	Low-cost Water Body
土壤修复专业	Soil Remediation Professional
土壤污染绿色	Soil Pollution Green
噪声控制自然	Noise Control Natural
环境评价应用	Environmental Assessment Applied
大型土壤污染	Large Soil Pollution
理论水资源短缺	Theoretical Water Scarcity
基础生物多样性减少	Basic Biodiversity Loss
便携气候变化	Portable Climate Change
大气绿色	Atmosphere Green
超大型噪声控制	Extra-large Noise Control
微型环境管理	Micro Environmental Management
移动环境规划	Mobile Environmental Planning
森林锐减智能	Forest Decline Intelligent
水资源短缺高效	Water Scarcity Efficient
土壤绿色	Soil Green
中型环境规划	Medium Environmental Planning
大型水污染	Large Water Pollution
噪声控制智能	Noise Control Intelligent
可持续海平面上升	Sustainable Sea Level Rise
传统全球变暖	Traditional Global Warming
理论土壤修复	Theoretical Soil Remediation
标准海平面上升	Standard Sea Level Rise
智能极端天气	Intelligent Extreme Weather
湿地保护微型	Wetland Protection Micro
自然全球变暖	Natural Global Warming
绿色海平面上升	Green Sea Level Rise
固废处理标准	Solid Waste Treatment Standard
清洁生产特殊	Cleaner Production Special
重要酸雨	Important Acid Rain
森林锐减人工	Forest Decline Artificial
生物多样性自然	Biodiversity Natural
生态系统小型	Ecosystem Small
大气可持续	Atmosphere Sustainable
水体迷你	Water Body Mini
可持续土壤	Sustainable Soil
重要环保产业	Important Environmental Protection Industry
固定辐射	Fixed Radiation
噪声控制数字化	Noise Control Digital
固体废物专业	Solid Waste Professional
新型土壤修复	Novel Soil Remediation
自然可持续发展	Natural Sustainable Development
新型生态文明	Novel Ecological Civilization
生态修复新型	Ecological Restoration Novel
生物多样性减少人工	Biodiversity Loss Artificial
放射性污染大型	Radioactive Pollution Large
迷你清洁生产	Mini Cleaner Production
标准光污染	Standard Light Pollution
生态生物	Ecological Organism
放射性污染专业	Radioactive Pollution Professional
实用森林锐减	Practical Forest Decline
超大型大气	Extra-large Atmosphere
废气处理重要	Exhaust Gas Treatment Important
环境规划系统性	Environmental Planning Systematic
荒漠化移动	Desertification Mobile
生态修复传统	Ecological Restoration Traditional
土壤基础	Soil Basic
关键土壤	Key Soil
重要荒漠化	Important Desertification
新型荒漠化防治	Novel Desertification Control
海平面上升高性能	Sea Level Rise High-performance
生态清洁生产	Ecological Cleaner Production
水体数字化	Water Body Digital
热污染标准	Thermal Pollution Standard
臭氧层破坏移动	Ozone Depletion Mobile
绿色发展绿色	Green Development Green
远程酸雨	Remote Acid Rain
重要大气	Important Atmosphere
便携环保产业	Portable Environmental Protection Industry
放射性污染重要	Radioactive Pollution Important
固废处理远程	Solid Waste Treatment Remote
全球变暖理论	Global Warming Theoretical
固废处理现代	Solid Waste Treatment Modern
土壤污染重要	Soil Pollution Important
水资源短缺固定	Water Scarcity Fixed
实用森林保护	Practical Forest Protection
气候变化自然	Climate Change Natural
臭氧层破坏小型	Ozone Depletion Small
重金属污染生态	Heavy Metal Pollution Ecological
人工土壤	Artificial Soil
水污染低成本	Water Pollution Low-cost
海平面上升综合	Sea Level Rise Comprehensive
便携生态系统	Portable Ecosystem
环保噪声污染	Eco-friendly Noise Pollution
自然废气处理	Natural Exhaust Gas Treatment
低成本污水处理	Low-cost Wastewater Treatment
可持续生态系统	Sustainable Ecosystem
现代森林保护	Modern Forest Protection
可持续发展重要	Sustainable Development Important
生物新型	Organism Novel
应用水污染	Applied Water Pollution
理论循环经济	Theoretical Circular Economy
核心污水处理	Core Wastewater Treatment
全球变暖自然	Global Warming Natural
可持续发展核心	Sustainable Development Core
实用固体废物	Practical Solid Waste
特殊土壤污染	Special Soil Pollution
土壤修复微型	Soil Remediation Micro
放射性污染智能	Radioactive Pollution Intelligent
绿色循环经济	Green Circular Economy
绿色发展可持续	Green Development Sustainable
固体废物迷你	Solid Waste Mini
经典臭氧层破坏	Classic Ozone Depletion
可持续极端天气	Sustainable Extreme Weather
低成本臭氧层破坏	Low-cost Ozone Depletion
环境规划高效	Environmental Planning Efficient
绿色发展核心	Green Development Core
远程荒漠化	Remote Desertification
环境监测有机	Environmental Monitoring Organic
标准荒漠化	Standard Desertification
噪声环保	Noise Eco-friendly
核心环保产业	Core Environmental Protection Industry
臭氧层破坏经典	Ozone Depletion Classic
生态修复现代	Ecological Restoration Modern
荒漠化防治基础	Desertification Control Basic
全球变暖超大型	Global Warming Extra-large
污水处理实用	Wastewater Treatment Practical
新型生态修复	Novel Ecological Restoration
热污染可持续	Thermal Pollution Sustainable
微型土壤污染	Micro Soil Pollution
实用海平面上升	Practical Sea Level Rise
远程环境监测	Remote Environmental Monitoring
自然环境管理	Natural Environmental Management
生态修复专业	Ecological Restoration Professional
荒漠化防治应用	Desertification Control Applied
固废处理环保	Solid Waste Treatment Eco-friendly
微型重金属污染	Micro Heavy Metal Pollution
数字化大气	Digital Atmosphere
污水处理重要	Wastewater Treatment Important
废气处理智能	Exhaust Gas Treatment Intelligent
绿色发展便携	Green Development Portable
白色污染高效	White Pollution Efficient
移动噪声污染	Mobile Noise Pollution
环保荒漠化防治	Eco-friendly Desertification Control
远程有机污染	Remote Organic Pollution
先进可持续发展	Advanced Sustainable Development
生物经典	Organism Classic
噪声污染系统性	Noise Pollution Systematic
经典循环经济	Classic Circular Economy
传统重金属污染	Traditional Heavy Metal Pollution
新型辐射	Novel Radiation
迷你大气污染	Mini Air Pollution
大气中型	Atmosphere Medium
经典放射性污染	Classic Radioactive Pollution
低成本大气	Low-cost Atmosphere
生态文明重要	Ecological Civilization Important
经典森林锐减	Classic Forest Decline
可持续发展综合	Sustainable Development Comprehensive
环保生物多样性减少	Eco-friendly Biodiversity Loss
全球变暖低成本	Global Warming Low-cost
智能噪声控制	Intelligent Noise Control
有机污染系统性	Organic Pollution Systematic
传统生物多样性	Traditional Biodiversity
白色污染经典	White Pollution Classic
水污染特殊	Water Pollution Special
大型固废处理	Large Solid Waste Treatment
臭氧层破坏大型	Ozone Depletion Large
土壤数字化	Soil Digital
气候变化高效	Climate Change Efficient
土壤污染关键	Soil Pollution Key
基础森林锐减	Basic Forest Decline
海平面上升传统	Sea Level Rise Traditional
全球变暖先进	Global Warming Advanced
关键海平面上升	Key Sea Level Rise
实用土壤污染	Practical Soil Pollution
酸雨关键	Acid Rain Key
土壤移动	Soil Mobile
小型环境监测	Small Environmental Monitoring
重金属污染特殊	Heavy Metal Pollution Special
远程大气	Remote Atmosphere
生物多样性保护系统性	Biodiversity Conservation Systematic
极端天气系统性	Extreme Weather Systematic
极端天气超大型	Extreme Weather Extra-large
噪声自然	Noise Natural
土壤修复新型	Soil Remediation Novel
实用土壤	Practical Soil
环保产业便携	Environmental Protection Industry Portable
生态湿地保护	Ecological Wetland Protection
环境规划专业	Environmental Planning Professional
综合辐射	Comprehensive Radiation
土壤修复标准	Soil Remediation Standard
综合环保产业	Comprehensive Environmental Protection Industry
高性能可持续发展	High-performance Sustainable Development
绿色森林保护	Green Forest Protection
生物多样性保护生态	Biodiversity Conservation Ecological
先进大气	Advanced Atmosphere
核心水体	Core Water Body
固定可持续发展	Fixed Sustainable Development
有机污染大型	Organic Pollution Large
环境评价先进	Environmental Assessment Advanced
中型水污染	Medium Water Pollution
高效绿色发展	Efficient Green Development
光污染固定	Light Pollution Fixed
生态文明实用	Ecological Civilization Practical
环保产业高性能	Environmental Protection Industry High-performance
森林锐减便携	Forest Decline Portable
土壤大型	Soil Large
白色污染大型	White Pollution Large
经典可持续发展	Classic Sustainable Development
系统性放射性污染	Systematic Radioactive Pollution
水体综合	Water Body Comprehensive
环保全球变暖	Eco-friendly Global Warming
有机污染标准	Organic Pollution Standard
理论生态文明	Theoretical Ecological Civilization
综合环境监测	Comprehensive Environmental Monitoring
应用放射性污染	Applied Radioactive Pollution
超大型生物	Extra-large Organism
土壤系统性	Soil Systematic
有机污染人工	Organic Pollution Artificial
酸雨专业	Acid Rain Professional
酸雨低成本	Acid Rain Low-cost
理论臭氧层破坏	Theoretical Ozone Depletion
噪声污染远程	Noise Pollution Remote
清洁生产系统性	Cleaner Production Systematic
生物微型	Organism Micro
土壤关键	Soil Key
微型清洁生产	Micro Cleaner Production
绿色发展数字化	Green Development Digital
综合水污染	Comprehensive Water Pollution
可持续发展可持续	Sustainable Development Sustainable
高效生物	Efficient Organism
清洁生产远程	Cleaner Production Remote
水污染应用	Water Pollution Applied
土壤应用	Soil Applied
噪声污染迷你	Noise Pollution Mini
土壤重要	Soil Important
辐射低成本	Radiation Low-cost
大气污染综合	Air Pollution Comprehensive
自然辐射	Natural Radiation
系统性重金属污染	Systematic Heavy Metal Pollution
人工土壤修复	Artificial Soil Remediation
先进清洁生产	Advanced Cleaner Production
湿地保护综合	Wetland Protection Comprehensive
辐射有机	Radiation Organic
大气便携	Atmosphere Portable
循环经济关键	Circular Economy Key
