社会结构	Social Structure
社会关系	Social Relationship
社会组织	Social Organization
社会制度	Social Institution
社会变迁	Social Change
社会流动	Social Mobility
社会分层	Social Stratification
社会网络	Social Network
社会资本	Social Capital
社会认同	Social Identity
家庭	Family
社区	Community
民族	Ethnicity
阶级	Class
阶层	Stratum
性别	Gender
年龄群体	Age Group
职业群体	Occupational Group
宗教群体	Religious Group
亚文化群体	Subcultural Group
贫困	Poverty
失业	Unemployment
犯罪	Crime
自杀	Suicide
吸毒	Drug Addiction
卖淫	Prostitution
家庭暴力	Domestic Violence
校园欺凌	School Bullying
社会排斥	Social Exclusion
社会不平等	Social Inequality
问卷调查	Questionnaire Survey
访谈	Interview
观察法	Observation Method
实验法	Experimental Method
文献分析	Literature Analysis
内容分析	Content Analysis
生活史法	Life History Method
案例研究	Case Study
比较研究	Comparative Study
行动研究	Action Research
功能主义	Functionalism
冲突理论	Conflict Theory
符号互动论	Symbolic Interactionism
结构主义	Structuralism
后现代主义	Postmodernism
女性主义	Feminism
批判理论	Critical Theory
理性选择理论	Rational Choice Theory
社会建构论	Social Constructionism
文化研究	Cultural Studies
社会变迁固定	Social Change Fixed
远程亚文化群体	Remote Subcultural Group
智能结构主义	Intelligent Structuralism
高效贫困	Efficient Poverty
社会分层绿色	Social Stratification Green
小型访谈	Small Interview
贫困远程	Poverty Remote
固定内容分析	Fixed Content Analysis
标准访谈	Standard Interview
行动研究可持续	Action Research Sustainable
社会制度有机	Social Institution Organic
理性选择理论现代	Rational Choice Theory Modern
微型结构主义	Micro Structuralism
批判理论环保	Critical Theory Eco-friendly
后现代主义核心	Postmodernism Core
实用符号互动论	Practical Symbolic Interactionism
功能主义移动	Functionalism Mobile
社会变迁系统性	Social Change Systematic
实用行动研究	Practical Action Research
民族超大型	Ethnicity Extra-large
环保家庭	Eco-friendly Family
固定功能主义	Fixed Functionalism
自然案例研究	Natural Case Study
比较研究超大型	Comparative Study Extra-large
家庭核心	Family Core
家庭传统	Family Traditional
小型社会制度	Small Social Institution
特殊实验法	Special Experimental Method
环保民族	Eco-friendly Ethnicity
理论社会分层	Theoretical Social Stratification
社会组织现代	Social Organization Modern
绿色理性选择理论	Green Rational Choice Theory
标准社会变迁	Standard Social Change
后现代主义高效	Postmodernism Efficient
社会结构中型	Social Structure Medium
实用生活史法	Practical Life History Method
迷你社会流动	Mini Social Mobility
大型批判理论	Large Critical Theory
吸毒便携	Drug Addiction Portable
女性主义先进	Feminism Advanced
社会组织创新	Social Organization Innovative
实验法重要	Experimental Method Important
观察法自然	Observation Method Natural
亚文化群体现代	Subcultural Group Modern
结构主义固定	Structuralism Fixed
中型职业群体	Medium Occupational Group
数字化内容分析	Digital Content Analysis
专业犯罪	Professional Crime
社会流动小型	Social Mobility Small
吸毒系统性	Drug Addiction Systematic
社区专业	Community Professional
冲突理论大型	Conflict Theory Large
观察法中型	Observation Method Medium
创新后现代主义	Innovative Postmodernism
职业群体特殊	Occupational Group Special
大型社会不平等	Large Social Inequality
社会资本理论	Social Capital Theoretical
阶级大型	Class Large
社会组织有机	Social Organization Organic
环保社会关系	Eco-friendly Social Relationship
社区人工	Community Artificial
生活史法自然	Life History Method Natural
实验法应用	Experimental Method Applied
中型自杀	Medium Suicide
综合年龄群体	Comprehensive Age Group
贫困实用	Poverty Practical
比较研究高效	Comparative Study Efficient
阶级理论	Class Theoretical
问卷调查关键	Questionnaire Survey Key
社会不平等自然	Social Inequality Natural
创新民族	Innovative Ethnicity
超大型年龄群体	Extra-large Age Group
应用家庭暴力	Applied Domestic Violence
重要观察法	Important Observation Method
超大型犯罪	Extra-large Crime
社会变迁现代	Social Change Modern
宗教群体中型	Religious Group Medium
阶层综合	Stratum Comprehensive
社区重要	Community Important
自杀实用	Suicide Practical
问卷调查人工	Questionnaire Survey Artificial
贫困经典	Poverty Classic
犯罪智能	Crime Intelligent
系统性比较研究	Systematic Comparative Study
行动研究智能	Action Research Intelligent
社会结构小型	Social Structure Small
观察法可持续	Observation Method Sustainable
固定案例研究	Fixed Case Study
社会认同固定	Social Identity Fixed
应用行动研究	Applied Action Research
数字化失业	Digital Unemployment
传统年龄群体	Traditional Age Group
亚文化群体自然	Subcultural Group Natural
社会建构论固定	Social Constructionism Fixed
社会结构应用	Social Structure Applied
家庭暴力应用	Domestic Violence Applied
失业专业	Unemployment Professional
可持续行动研究	Sustainable Action Research
绿色民族	Green Ethnicity
行动研究数字化	Action Research Digital
符号互动论智能	Symbolic Interactionism Intelligent
失业环保	Unemployment Eco-friendly
社会变迁特殊	Social Change Special
标准文献分析	Standard Literature Analysis
社会变迁综合	Social Change Comprehensive
有机文化研究	Organic Cultural Studies
绿色批判理论	Green Critical Theory
犯罪大型	Crime Large
系统性问卷调查	Systematic Questionnaire Survey
核心社会资本	Core Social Capital
问卷调查生态	Questionnaire Survey Ecological
后现代主义基础	Postmodernism Basic
民族迷你	Ethnicity Mini
可持续民族	Sustainable Ethnicity
阶级标准	Class Standard
社会分层微型	Social Stratification Micro
绿色问卷调查	Green Questionnaire Survey
问卷调查理论	Questionnaire Survey Theoretical
理性选择理论便携	Rational Choice Theory Portable
女性主义关键	Feminism Key
生活史法高效	Life History Method Efficient
应用民族	Applied Ethnicity
访谈关键	Interview Key
高性能社区	High-performance Community
社会组织经典	Social Organization Classic
社会认同数字化	Social Identity Digital
可持续社会制度	Sustainable Social Institution
特殊理性选择理论	Special Rational Choice Theory
微型内容分析	Micro Content Analysis
社会建构论基础	Social Constructionism Basic
固定冲突理论	Fixed Conflict Theory
传统社会网络	Traditional Social Network
宗教群体经典	Religious Group Classic
实用女性主义	Practical Feminism
新型社会资本	Novel Social Capital
案例研究小型	Case Study Small
访谈绿色	Interview Green
家庭自然	Family Natural
阶级迷你	Class Mini
社会组织先进	Social Organization Advanced
女性主义数字化	Feminism Digital
案例研究移动	Case Study Mobile
大型社会组织	Large Social Organization
性别大型	Gender Large
创新社会排斥	Innovative Social Exclusion
文化研究理论	Cultural Studies Theoretical
超大型阶层	Extra-large Stratum
迷你阶层	Mini Stratum
小型家庭暴力	Small Domestic Violence
人工卖淫	Artificial Prostitution
高效犯罪	Efficient Crime
自然贫困	Natural Poverty
批判理论自然	Critical Theory Natural
批判理论理论	Critical Theory Theoretical
亚文化群体专业	Subcultural Group Professional
有机犯罪	Organic Crime
创新宗教群体	Innovative Religious Group
小型文献分析	Small Literature Analysis
低成本案例研究	Low-cost Case Study
家庭特殊	Family Special
校园欺凌微型	School Bullying Micro
观察法重要	Observation Method Important
案例研究先进	Case Study Advanced
吸毒理论	Drug Addiction Theoretical
移动民族	Mobile Ethnicity
高效社会制度	Efficient Social Institution
便携失业	Portable Unemployment
超大型吸毒	Extra-large Drug Addiction
小型年龄群体	Small Age Group
社会关系远程	Social Relationship Remote
社会结构环保	Social Structure Eco-friendly
微型职业群体	Micro Occupational Group
移动失业	Mobile Unemployment
社会网络综合	Social Network Comprehensive
理论亚文化群体	Theoretical Subcultural Group
标准自杀	Standard Suicide
社会关系重要	Social Relationship Important
冲突理论先进	Conflict Theory Advanced
环保宗教群体	Eco-friendly Religious Group
超大型民族	Extra-large Ethnicity
社会资本自然	Social Capital Natural
环保卖淫	Eco-friendly Prostitution
有机社会认同	Organic Social Identity
可持续女性主义	Sustainable Feminism
生态社会流动	Ecological Social Mobility
贫困移动	Poverty Mobile
基础观察法	Basic Observation Method
微型卖淫	Micro Prostitution
问卷调查大型	Questionnaire Survey Large
实验法迷你	Experimental Method Mini
人工文献分析	Artificial Literature Analysis
应用内容分析	Applied Content Analysis
环保文献分析	Eco-friendly Literature Analysis
社会网络特殊	Social Network Special
重要社会不平等	Important Social Inequality
吸毒绿色	Drug Addiction Green
失业核心	Unemployment Core
后现代主义人工	Postmodernism Artificial
阶级数字化	Class Digital
校园欺凌生态	School Bullying Ecological
冲突理论环保	Conflict Theory Eco-friendly
民族环保	Ethnicity Eco-friendly
微型社会资本	Micro Social Capital
职业群体先进	Occupational Group Advanced
重要阶层	Important Stratum
访谈可持续	Interview Sustainable
实验法生态	Experimental Method Ecological
社会建构论智能	Social Constructionism Intelligent
访谈基础	Interview Basic
应用观察法	Applied Observation Method
系统性吸毒	Systematic Drug Addiction
阶层大型	Stratum Large
智能文化研究	Intelligent Cultural Studies
性别生态	Gender Ecological
校园欺凌数字化	School Bullying Digital
环保社区	Eco-friendly Community
社会分层标准	Social Stratification Standard
远程观察法	Remote Observation Method
民族专业	Ethnicity Professional
中型社会排斥	Medium Social Exclusion
自然社会排斥	Natural Social Exclusion
标准职业群体	Standard Occupational Group
社会结构生态	Social Structure Ecological
高性能社会网络	High-performance Social Network
问卷调查可持续	Questionnaire Survey Sustainable
卖淫经典	Prostitution Classic
人工社会变迁	Artificial Social Change
核心亚文化群体	Core Subcultural Group
自然社会不平等	Natural Social Inequality
内容分析移动	Content Analysis Mobile
先进内容分析	Advanced Content Analysis
贫困理论	Poverty Theoretical
绿色后现代主义	Green Postmodernism
自然内容分析	Natural Content Analysis
社会流动便携	Social Mobility Portable
小型比较研究	Small Comparative Study
内容分析生态	Content Analysis Ecological
案例研究超大型	Case Study Extra-large
高性能吸毒	High-performance Drug Addiction
超大型理性选择理论	Extra-large Rational Choice Theory
生态内容分析	Ecological Content Analysis
环保冲突理论	Eco-friendly Conflict Theory
小型理性选择理论	Small Rational Choice Theory
有机文献分析	Organic Literature Analysis
专业卖淫	Professional Prostitution
问卷调查迷你	Questionnaire Survey Mini
社会资本标准	Social Capital Standard
有机案例研究	Organic Case Study
传统社会流动	Traditional Social Mobility
访谈应用	Interview Applied
自杀环保	Suicide Eco-friendly
标准批判理论	Standard Critical Theory
小型民族	Small Ethnicity
民族固定	Ethnicity Fixed
专业社会网络	Professional Social Network
应用社会变迁	Applied Social Change
系统性社会认同	Systematic Social Identity
案例研究自然	Case Study Natural
贫困超大型	Poverty Extra-large
移动文献分析	Mobile Literature Analysis
社会关系自然	Social Relationship Natural
吸毒标准	Drug Addiction Standard
案例研究人工	Case Study Artificial
犯罪系统性	Crime Systematic
文献分析应用	Literature Analysis Applied
微型民族	Micro Ethnicity
大型亚文化群体	Large Subcultural Group
高效校园欺凌	Efficient School Bullying
可持续卖淫	Sustainable Prostitution
低成本社会网络	Low-cost Social Network
数字化社会组织	Digital Social Organization
有机社会不平等	Organic Social Inequality
可持续社会关系	Sustainable Social Relationship
社会结构微型	Social Structure Micro
家庭人工	Family Artificial
关键访谈	Key Interview
中型社会建构论	Medium Social Constructionism
家庭暴力固定	Domestic Violence Fixed
环保结构主义	Eco-friendly Structuralism
智能社会组织	Intelligent Social Organization
家庭移动	Family Mobile
大型性别	Large Gender
社会流动远程	Social Mobility Remote
标准案例研究	Standard Case Study
基础吸毒	Basic Drug Addiction
校园欺凌实用	School Bullying Practical
小型社会分层	Small Social Stratification
犯罪超大型	Crime Extra-large
功能主义远程	Functionalism Remote
低成本宗教群体	Low-cost Religious Group
社会认同大型	Social Identity Large
职业群体低成本	Occupational Group Low-cost
社会组织固定	Social Organization Fixed
社会排斥有机	Social Exclusion Organic
实验法综合	Experimental Method Comprehensive
微型后现代主义	Micro Postmodernism
环保案例研究	Eco-friendly Case Study
社会网络实用	Social Network Practical
理论观察法	Theoretical Observation Method
性别数字化	Gender Digital
问卷调查微型	Questionnaire Survey Micro
人工观察法	Artificial Observation Method
冲突理论专业	Conflict Theory Professional
文化研究核心	Cultural Studies Core
环保贫困	Eco-friendly Poverty
新型功能主义	Novel Functionalism
固定符号互动论	Fixed Symbolic Interactionism
功能主义特殊	Functionalism Special
校园欺凌专业	School Bullying Professional
文献分析传统	Literature Analysis Traditional
吸毒有机	Drug Addiction Organic
功能主义经典	Functionalism Classic
民族便携	Ethnicity Portable
阶层智能	Stratum Intelligent
传统失业	Traditional Unemployment
社会分层自然	Social Stratification Natural
案例研究传统	Case Study Traditional
社会不平等移动	Social Inequality Mobile
性别综合	Gender Comprehensive
实用观察法	Practical Observation Method
关键案例研究	Key Case Study
亚文化群体生态	Subcultural Group Ecological
冲突理论绿色	Conflict Theory Green
可持续访谈	Sustainable Interview
自杀移动	Suicide Mobile
社会结构综合	Social Structure Comprehensive
关键社会关系	Key Social Relationship
标准冲突理论	Standard Conflict Theory
实验法自然	Experimental Method Natural
失业便携	Unemployment Portable
迷你案例研究	Mini Case Study
经典性别	Classic Gender
社会组织环保	Social Organization Eco-friendly
社会网络理论	Social Network Theoretical
小型社区	Small Community
阶层低成本	Stratum Low-cost
案例研究固定	Case Study Fixed
亚文化群体应用	Subcultural Group Applied
重要自杀	Important Suicide
固定社会建构论	Fixed Social Constructionism
生活史法传统	Life History Method Traditional
现代年龄群体	Modern Age Group
系统性符号互动论	Systematic Symbolic Interactionism
性别绿色	Gender Green
关键社会流动	Key Social Mobility
固定后现代主义	Fixed Postmodernism
传统社会建构论	Traditional Social Constructionism
社区特殊	Community Special
后现代主义经典	Postmodernism Classic
综合民族	Comprehensive Ethnicity
绿色家庭	Green Family
结构主义高性能	Structuralism High-performance
文献分析专业	Literature Analysis Professional
专业民族	Professional Ethnicity
数字化案例研究	Digital Case Study
人工社会流动	Artificial Social Mobility
文化研究大型	Cultural Studies Large
社会组织核心	Social Organization Core
失业移动	Unemployment Mobile
社会建构论特殊	Social Constructionism Special
大型社会资本	Large Social Capital
访谈微型	Interview Micro
社会结构智能	Social Structure Intelligent
生态冲突理论	Ecological Conflict Theory
高效卖淫	Efficient Prostitution
理论问卷调查	Theoretical Questionnaire Survey
性别自然	Gender Natural
高性能校园欺凌	High-performance School Bullying
校园欺凌环保	School Bullying Eco-friendly
冲突理论小型	Conflict Theory Small
低成本问卷调查	Low-cost Questionnaire Survey
家庭应用	Family Applied
可持续批判理论	Sustainable Critical Theory
理性选择理论核心	Rational Choice Theory Core
数字化文献分析	Digital Literature Analysis
环保观察法	Eco-friendly Observation Method
内容分析传统	Content Analysis Traditional
社会分层经典	Social Stratification Classic
系统性社会结构	Systematic Social Structure
内容分析超大型	Content Analysis Extra-large
理论犯罪	Theoretical Crime
文献分析核心	Literature Analysis Core
社会制度应用	Social Institution Applied
观察法先进	Observation Method Advanced
生活史法数字化	Life History Method Digital
实验法微型	Experimental Method Micro
生活史法基础	Life History Method Basic
比较研究智能	Comparative Study Intelligent
卖淫低成本	Prostitution Low-cost
社会网络低成本	Social Network Low-cost
自杀数字化	Suicide Digital
问卷调查移动	Questionnaire Survey Mobile
中型社会网络	Medium Social Network
便携社会关系	Portable Social Relationship
阶层现代	Stratum Modern
有机批判理论	Organic Critical Theory
宗教群体专业	Religious Group Professional
失业中型	Unemployment Medium
问卷调查实用	Questionnaire Survey Practical
实用案例研究	Practical Case Study
标准观察法	Standard Observation Method
超大型社会制度	Extra-large Social Institution
微型社会制度	Micro Social Institution
社会制度高效	Social Institution Efficient
批判理论特殊	Critical Theory Special
社会关系有机	Social Relationship Organic
专业家庭	Professional Family
吸毒可持续	Drug Addiction Sustainable
自然后现代主义	Natural Postmodernism
标准符号互动论	Standard Symbolic Interactionism
自然犯罪	Natural Crime
经典家庭暴力	Classic Domestic Violence
社会制度数字化	Social Institution Digital
迷你冲突理论	Mini Conflict Theory
文献分析理论	Literature Analysis Theoretical
人工社会建构论	Artificial Social Constructionism
远程女性主义	Remote Feminism
社会变迁低成本	Social Change Low-cost
实用阶层	Practical Stratum
迷你实验法	Mini Experimental Method
社会建构论专业	Social Constructionism Professional
环保访谈	Eco-friendly Interview
问卷调查核心	Questionnaire Survey Core
便携社会分层	Portable Social Stratification
年龄群体小型	Age Group Small
人工问卷调查	Artificial Questionnaire Survey
家庭中型	Family Medium
符号互动论特殊	Symbolic Interactionism Special
实用冲突理论	Practical Conflict Theory
社区关键	Community Key
女性主义高性能	Feminism High-performance
社会变迁重要	Social Change Important
先进贫困	Advanced Poverty
便携贫困	Portable Poverty
先进阶级	Advanced Class
高性能亚文化群体	High-performance Subcultural Group
小型内容分析	Small Content Analysis
社会变迁核心	Social Change Core
超大型案例研究	Extra-large Case Study
基础阶级	Basic Class
内容分析现代	Content Analysis Modern
关键社会不平等	Key Social Inequality
综合社会网络	Comprehensive Social Network
社会变迁专业	Social Change Professional
环保女性主义	Eco-friendly Feminism
社会结构数字化	Social Structure Digital
社会流动绿色	Social Mobility Green
高性能实验法	High-performance Experimental Method
社会建构论新型	Social Constructionism Novel
家庭重要	Family Important
符号互动论标准	Symbolic Interactionism Standard
